は い: hai (yes)
す し: sushi
わ さ び: wasabi (the green spicy stuff you eat with sushi)
ひ ら が な: hiragana (one of the two phonetic alphabets)
か た か な: katakana
か た: kata (sword)
さ む ら い: samurai
せ っ ぷ く: seppuku (also known as harakiri)
は ら き り: harakiri
さ よ な ら: sayonara (formal good bye)
こ ん に ち は: konnichiwa (formal greeting; note that it is spelled konnichiha, but the pronounciation is irregular)
ま き: maki (sushi rolls)
と う[long] きょ う[long]: To–kyo–
きょ う[long] と: Kyo–to
お お[long] さ か: O–saka
に ほ ん: Nihon (Japan; also known as "Nippon" – this is an old-fashioned pronounciation)
に っ ぽ ん: Nippon (Japan, though normally "Japan" is called にほん, "Nihon")
に ほ ん ご: Nihongo (Japanese)
か み か ぜ: Kamikaze (literally "Divine Wind")
ば ん さ い: Banzai (shouted by Japanese soldiers during the second world world – literal meaning "[May the emperor live for] 10,000 years")
は い く: Haiku (Japanese poetry form)
い け ば な: Ikebana (traditional art of flower arrangement)
か ぶ き: Kabuki (traditional form of theater)
か ら お け: Karaoke
ま ん が: Manga (comics)
お り が み: Origami (literally "folding paper")
お た く: Otaku (nerd)
き も の: Kimono
べ ん と う[long]: Bento– (lunchbox)
じゅ う[long] ど う[long]: Ju–do– (Judo)
か ら て: Karate
け ん ど う[long]: Kendo– (traditional sword fighting art)
え だ ま め: Edamame (green beans)

だ い こ ん: Daikon (radish)
ふ ぐ: Fugu (Blowfish)
ぎょ う[long] ざ: Gyo–za (Dumplings)
き り ん: Kirin (Beer brand)
い ち ば ん: Ichiban (First)
み そ: Miso (broth)
う ど ん: Udon (a kind of noodles)
ら め ん: Ramen (a kind of noodles)
の り: Nori (sea weed, used e.g. to make sushi rolls)
さ し み: Sashimi (raw fish)
し い[long] た け: Shi–take (a kind of mushroom)
そ ば: Soba (a kind of noodles)
す き や き: Sukiyaki (type of hot pot dish)
て ん ぷ ら: Tenpura (deep-fried vegetables or shellfish; often transliterated as "tempura")
て っ ぱ ん や き: Teppanyaki (food fried on a communal hot plate)
う ま み: Umami (in the West: one of the five basic tastes, in Japanese: "deliciousness")
や き と り: Yakitori (fried chicken)
しょ う[long] ぐ ん: Sho–gun (a feudal lord in Medieval Japan, famous in the West from the book by the same name)
あ い き ど う[long]: Aikido– (a martial art)
ど う[long] じょ う[long]: Do–jo– (hall used for martial arts training)
じゅ う[long] じゅ つ: Ju–jutsu (a martial art)
す も う[long]: Sumo–
ぜ ん: Zen
げ い しゃ: Geisha
ふ と ん: Futon (a Japanese-style mattress)
え も じ: Emoji
か た な: Katana (a style of sword)
か わ い い[long]: Kawai– (cute)
せ ん せ い: Sensei (teacher)
し あ つ: Shiatsu (massage)
す う[long] ど く: Su–doku
す み ま せ ん: Sumimasen (sorry)
あ り が と う[long]: Arigato– (thanks)
つ な み: Tsunami
し ん か ん せ ん: Shinkansen (Japanese high speed train)
ぽ け も ん: Pokemon
り く しゃ: Rikusha (the origin of the word rickshaw)
と よ た: Toyota
み つ び し: Mitsubishi
に っ さ ん: Nissan
す ず き: Suzuki
た ま ご ち: Tamagochi
む ら か み: Murakami (family name)
お の よ う[long] こ: Ono Yo–ko
ひ ろ し ま: Hiroshima (city)
ふ き し ま: Fukushima (city)
ふ じ: Fuji (mountain)
く ろ さ わ あ き ら: Kurosawa Akira (director)
お び: Obi (belt worn with a kimono)
や ま は: Yamaha
お ん せ ん: Onsen (hot spring)
さ く ら: Sakura
と う[long] ふ: To–fu (bean curd)
て: Te (hand)
ま っ て: Matte (wait)
て あ ら い: Tearai (toilet)
で ぐ ち: Deguchi (exit)
ちょ っ と: Chotto (a little bit)
え び: Ebi (Shrimp)
ぎ り: Giri (dury)
ず っ と: Zutto (for a long time)
け い ざ い: Keizai (economy)
ぜ っ た い: Zeittai (definitely)
で る: Deru (to leave)
ざ っ か: Zakka (variety shop)
ひ と: hito (people)
ほ ね: hone (feathre)
で す[silent]: desu (to be)

で き る: dekiru (to be able)
ね ぎ: negi (leek)
だ め: dame (forbidden, bad)
あ る: aru (to be)
な べ: nabe (pan)
ね こ: neko (cat)
ま ね き ね こ: Manekineko (the beckoning cat present in many Chinese and Japanese shops)
う め: ume (plum, also a first name)
そ と: soto (outside)
た っ ぷ り: tappuri (in plenty)
や っ ぱ り: yappari (in any case)
び ん ぼ う[long]: binbo– (poor)
ひ: hi (sun)
ぎ ん: gin (gold)
ざ ら ざ ら: zarazara (sound denoting something course to the touch)
て ら: tera (temple)
き っ ぷ: kippu (ticket)

// TODO: Grammar rule for suppressing syllables?
め ちゃ く[silent] ちゃ: mechakucha (chaotic, note: the "u" is irregularly not pronounced)
ば ば: baba (grandmother)
ほ ん と う[long]: honto– (truth)
ほ ほ え む: hohoemu (to smile)
た ん ぽ ぽ: tanpopo (dandelion)
ち ち: chichi (father)

げ ろ げ ろ (requires: onematopoeia): Gerogero (the sound a frog makes)
え び す: Ebisu (area in Tokyo)
ぎ ふ: Gifu (prefecture)
きゅ う[long] しゅ う[long]: Kyu–shu– (the southern island of Japan)
な ご や: Nagoya (city)
し ぶ や: Shibuya (area in Tokyo)
や ま が た: Yamagata (city and prefecture)
よ こ は ま: Yokohama (city)
ひょ う[long] ご: Hyougo (city)
よ し わ ら: Yoshiwara (the entertainment district in the middle ages in what is now Tokyo)
み や ぎ: Miyagi (city)
ぐ ん ま: Gunma (prefecture)
か わ ぐ ち: Kawaguchi (city)
さ っ ぽ ろ: Sapporo (city)
ほ っ か い ど う[long]: Hokkaido– (the nothern island of Japan)
に い[long] が た: Ni–gata (city and prefecture)
あ そ: Aso (a volcano)
は こ ね: Hakone (city known for it's hot springs (おんせん))
よ う[long] こ: Yo–ko (woman's name)
め ぐ み: Megumi (woman's name)

ひ ろ し げ: Hirashige (name)
さ と う[long]: Sato– (name)
た か は し: Takahashi (name)
た な か: Tanaka (name)
わ た な べ: Watanabe (name)
い と う[long]: Ito– (name)
や ま も と: Yamamoto (name)
な か む ら: Nakamura (name)
こ ば や し: Kobayashi (name)
か と う[long]: Kato– (name)
よ し だ: Yoshida (name)
や ま だ: Yamada (name)
さ さ き: Sasaki (name)
や ま ぐ ち: Yamaguchi (name)
さ い と う[long]: Saito– (name)
ま つ も と: Matsumoto (name)
い の う え: Inoue (note: it's not a long "o", the "u" is actually pronounced, though there is no way of knowing that by the spelling)
き む ら: Kimura (name)
は や し: Hayashi (name)
し み ず: Shimizu (name)
や ま ざ き: Yamazaki (name)
も り: Mori (family name, also means forest)
あ べ: Abe (name)
い け だ: Ikeda (name)
は し も と: Hashimoto (name)
や ま し た: Yamashit (name)
い し か わ: Ishikawa (name)
な か じ ま: Nakajima (name)
ま え だ: Maeda (name)
ふ じ た: Fujitav (name)
ご と う[long]: Goto– (name)
お か だ: Okada (name)
は せ が わ: Hasegawa (name)
さ か も と: Sakamoto (name)
あ お き: Aoki (name)
に し む ら: Nishimura (name)
ふ く だ: Fukuda (name)
み う ら: Miura (name)
ふ じ わ ら: Fujiwara (name)
お か も と: Okamoto (name)
ま つ だ: Matsuda (name)
な か が わ: Nakagawa (name)
な か の: Nakano (name)
は ら だ: Harada (name)
た ま う ら: Tamaura (name)
た け う ち: Takeuchi (name)
か ね こ: Kaneko (name)
な か や ま: Nakayama (name)
い し だ: Ishida (name)
う え だ: Ueda (name)
も り た: Morita (name)
は ら: Hara (name)
さ か い: Sakari (name)
よ こ や ま: Yokoyama (name)
み や も と: Miyamoto (name)
う ち だ: Uchida (name)
た か ぎ: Takagi (name)
た に ぐ ち: Taniguchi (name)
お う の: O–no (name)
ま る や ま:　Maruyama (name)
い ま い: Imai (name)
た か だ: Takada (name)
ふ じ も と: Fujimoto (name)
た け だ: Takeda (name)
む ら た: Murata (name)
す ぎ や ま: Tagiyama (name)
ま す だ: Masuda (name)
す が わ ら: Sugawara (name)
ひ ら の: Hirano (name)
こ じ ま: Kojima (name)
お つ か: Otsuka (name)
ち ば: Chiba (name)
ま つ い: Matsui (name)
い わ さ き: Iwasaki (name)
さ く ら い: Sakurai (name)
き の し た: Kinoshita (name)
の ぐ ち: Noguchi (name)
ま つ お: Matsuo (name)
の む ら: Nomura (name)
き く ち: Kimuchi (name)
す ご も と: Sugomoto (name)
あ ら い: Arai (name)

い わ た: Iwata (name)
む ら: mura (town)
な か: naka (inside)
や ま: yama (Mountain)
の み も の: nomimono (drinks)
も の: mono (thing)
や く: yaku (to fry / burn)
い わ: iwa (rock)
か わ: kawa (river)
く も: kumo (cloud)
け が: kega (wound)
つ ぎ: tsugi (next)
け さ: kesa (this morning)
い け な い: ikenai (forbidden / not possible)
ほ け ん: hoken (insurance)
し お: shio (salt)
ふ つ う[long]: futsu– (normal)
ほ と ん ど: hotondo (almost)
ほ う[long] り つ: ho–ritsu (law)
や さ ひ ろ: Yasahiro (first name)
や す ひ ろ: Yasuhiro (first name)
た か ひ ろ: Takahiro (first name)
ひ ろ う: Hiro– (area in Tokyo)
ほ し: Hoshi (star / female name)
ふ く: fuku (clothes)
み ほ: Miho (female name)
ふ く さ つ: fukusatsu (complicated)
こ っ ち: kocchi (an informal way of saying "here")
ろ う[long] に ん: Ro–nin (a samurai without a master)
う え: ue (up)
み ち こ: Michiko (female name)
な お こ: Naoko (female name)
ひ で こ: Hideko (female name)
う で: ude (arm)
の ぼ る: Noboru (male name)
さ と る: Satoru (male name)
し げ る: Shigeru (male name)
い る: iru (to be)
じゅ っ ぷ ん: juppun (ten minutes)
げ っ ぷ: geppu (burp)
し ゃ べ る: shaberu (talk)
し ゃ め ん: shamen (slope)
し ゃ か い: shakai (society)
き ょ う[long] だ い: kyo–dai (parents)
ゆ き: Yuki (female name / snow)
ふ ゆ: Fuyu (winter)
し ゅ ふ: Shufu (housewife)
し ゅ う[long] り ょ う[long]: shu–ryo– (end)
ち ゃ ち: chachi (badly made)
に ち ゃ に ち ゃ (requires: onematopoeia): nichanicha (slimy)
ほ ぞ ん: storage
も く ぞ う: made out of wood
ご た ん だ: Gotanda (area in Tokyo)
ご ぞ ん じ: gozonji (to know, very formally)
ぬ ぐ: undress

// TODO: is the う actually a long vowel?
ぬ う: nuu (sew)
い い ぞ: ii zo (way to go!)
ぬ の: nuno (cloth)
え へ ん: ehen (ahem)
へ え[long]: hee ("really?" surprised sound)
へ い き: heiki (ok, fine)
ぞ く ぞ く (requires: onematopoeia): zokuzoku (shiver/feel chilly)
ぞ ろ ぞ ろ (requires: onematopoeia): zorozoro (in succession)
ど う[long] し て: do–shite (why)
し あ わ せ: shiawase (happy)
じ ゃ あ[long] ね: ja–ne (bye)
ぞ っ と (requires: onematopoeia): zotto (trembling/being horrified)
へ る: heru (to decrease)
ぬ ら ぬ ら: nuranura (slimy/slippery)
あ そ ぶ: asobu (to play)
ぶ ん か: bunka (culture)
ぐ ぶ ぐ ぶ (requires: onematopoeia): gubugubu (gurgling)
ぶ ら り (requires: onematopoeia): burari (unexpectedly)

い ぬ: inu (dog)

ぴ し ゃ っ と (requires: onematopoeia): pishatto (slapping/splatting)
ぴ っ た り (requires: onematopoeia): pittari (exactly, precisely)
ぴ り り (requires: onematopoeia): piriri (stinging)
え ん ぴ つ: enpitsu (pencil)
え ん ぴ つ け ず り: enpitsu kezuri (pencil sharpener)
ろ っ ぴ ゃ く: roppyaku (six hundred)

し ょ っ ぱ い: shoppai (salty)
は っ ぱ: happa (leaf)
ぱ っ と (requires: onematopoeia): patto (suddenly)
い っ ぱ ん: ippan (general, universal)

ぺ ち ゃ く[silent] ち ゃ: pechak[u]cha (patter, chattering)
い っ て き ま す[silent]: itte kimasu (phrase said when leaving, note: the "u" is unpronounced)
や め て: yamete ("stop it")
よ か っ た: yokatta ("thank Goodness")
じ ゃ ま だ: jama da ("you're in the way / disturbing")
な ん だ こ れ: nanda kore ("What the hell is this?")
い た だ き ま す[silent]: itadakimas[u] (Phrase said before eating)
お じ ゃ ま し ま す[silent]: ojama shimas[u] (Phrase said when entering a room, literally "I'm disturbing")
よ ろ し[silent] く お ね が い し ま す[silent]: yorosh[i]ku onegai shimas[u] (Phrase said when introducing yourself, literally "Please be nice to me")
ぼ ろ ぼ ろ (requires: onematopoeia): boroboro (worn, tattered)
ぽ ろ ぽ ろ (requires: onematopoeia): poroporo (in large drops)
ぼ や っ と (requires: onematopoeia): boyatto (absentmindedly)

ぺ ら ぺ ら (requires: onematopoeia): perapera (fluently)
た ん ぺ ん え い が: tanpen eiga (short film)
ど ろ ぼ う[long]: dorobo– (thief)

き れ い: kirei (beautiful)
れ き し: rekishi (history)
こ れ: kore (this)
こ わ れ る: kowareru (to break)
あ げ る: ageru (give)

な べ: nabe (pan)
い っ ぺ ん: ippen (at once)
か ん ぺ き: kanpeki (perfect)
く す り: kusuri (medicine)
く ず り: kuzuri (wolverine)
か ぜ: kaze (wind)
あ ん ぜ ん: anzen (safety)
す[silent] き: suki (to like)
す[silent] こ し: sukoshi (a little)
ご ち そ う[long] さ ま で し[silent] た: gochiso–sama deshita ("thanks for the treat"; said after being treated to food)

あ い: ai (love)

き を つ け て: ki (w)o tsukete (take care)
て を あ げ る: te (w)o ageru (to raise your hand)
ば か な こ と を い わ な い で: baka na koto (w)o iwanaide (don't say stupid things)
な に を い っ て る ん だ: nani o itterunda ("what are you saying?")
め を さ め る: me (w)o sameru (wake up)
く る ま を か う: kuruma (w)o kau (buy a car)
く じ: kuji (nine o'clock)
く る: kuru (to come)
ゆ め い: yumei (famous)
つ ゆ: tsuyu (rainy season)
し ん ぴ: shinpi (mystery)
も の が た り: monogatari (story)
い っ て ら っ し ゃ い: itterrasshai (phrase said to someone leaving)